"filename", "language", "JavaScript", "CSS", "JSON", "Markdown", "HTML", "comment", "blank", "total"
"c:\Users\Lenovo\saitynams_fe\react_register_form-main\README.md", "Markdown", 0, 0, 0, 9, 0, 0, 9, 18
"c:\Users\Lenovo\saitynams_fe\react_register_form-main\package-lock.json", "JSON", 0, 0, 27205, 0, 0, 0, 1, 27206
"c:\Users\Lenovo\saitynams_fe\react_register_form-main\package.json", "JSON", 0, 0, 40, 0, 0, 0, 1, 41
"c:\Users\Lenovo\saitynams_fe\react_register_form-main\public\index.html", "HTML", 0, 0, 0, 0, 17, 23, 3, 43
"c:\Users\Lenovo\saitynams_fe\react_register_form-main\public\manifest.json", "JSON", 0, 0, 25, 0, 0, 0, 1, 26
"c:\Users\Lenovo\saitynams_fe\react_register_form-main\src\App.js", "JavaScript", 60, 0, 0, 0, 0, 0, 11, 71
"c:\Users\Lenovo\saitynams_fe\react_register_form-main\src\api\axios.js", "JavaScript", 10, 0, 0, 0, 0, 0, 2, 12
"c:\Users\Lenovo\saitynams_fe\react_register_form-main\src\components\Appointments\AppointmentPage.js", "JavaScript", 45, 0, 0, 0, 0, 1, 8, 54
"c:\Users\Lenovo\saitynams_fe\react_register_form-main\src\components\Appointments\Appointments.js", "JavaScript", 84, 0, 0, 0, 0, 4, 10, 98
"c:\Users\Lenovo\saitynams_fe\react_register_form-main\src\components\Appointments\AppointmentsPage.js", "JavaScript", 15, 0, 0, 0, 0, 0, 3, 18
"c:\Users\Lenovo\saitynams_fe\react_register_form-main\src\components\Appointments\CreateAppointment.js", "JavaScript", 0, 0, 0, 0, 0, 0, 1, 1
"c:\Users\Lenovo\saitynams_fe\react_register_form-main\src\components\Appointments\EditAppointment.js", "JavaScript", 0, 0, 0, 0, 0, 0, 1, 1
"c:\Users\Lenovo\saitynams_fe\react_register_form-main\src\components\Authorization\Login.js", "JavaScript", 91, 0, 0, 0, 0, 1, 13, 105
"c:\Users\Lenovo\saitynams_fe\react_register_form-main\src\components\Authorization\Register.js", "JavaScript", 200, 0, 0, 0, 0, 4, 22, 226
"c:\Users\Lenovo\saitynams_fe\react_register_form-main\src\components\Authorization\RegisterDoctor.js", "JavaScript", 197, 0, 0, 0, 0, 4, 24, 225
"c:\Users\Lenovo\saitynams_fe\react_register_form-main\src\components\Authorization\RequireAuth.js", "JavaScript", 15, 0, 0, 0, 0, 0, 4, 19
"c:\Users\Lenovo\saitynams_fe\react_register_form-main\src\components\Authorization\Unauthorized.js", "JavaScript", 16, 0, 0, 0, 0, 0, 4, 20
"c:\Users\Lenovo\saitynams_fe\react_register_form-main\src\components\Editor.js", "JavaScript", 12, 0, 0, 0, 0, 0, 2, 14
"c:\Users\Lenovo\saitynams_fe\react_register_form-main\src\components\Home.js", "JavaScript", 12, 0, 0, 0, 0, 0, 4, 16
"c:\Users\Lenovo\saitynams_fe\react_register_form-main\src\components\Layout.js", "JavaScript", 9, 0, 0, 0, 0, 0, 2, 11
"c:\Users\Lenovo\saitynams_fe\react_register_form-main\src\components\Lounge.js", "JavaScript", 12, 0, 0, 0, 0, 0, 2, 14
"c:\Users\Lenovo\saitynams_fe\react_register_form-main\src\components\Missing.js", "JavaScript", 13, 0, 0, 0, 0, 0, 2, 15
"c:\Users\Lenovo\saitynams_fe\react_register_form-main\src\components\NavBar.js", "JavaScript", 30, 0, 0, 0, 0, 2, 7, 39
"c:\Users\Lenovo\saitynams_fe\react_register_form-main\src\components\Recommendations\CreateReccomendation.js", "JavaScript", 0, 0, 0, 0, 0, 0, 1, 1
"c:\Users\Lenovo\saitynams_fe\react_register_form-main\src\components\Recommendations\EditReccomendation.js", "JavaScript", 0, 0, 0, 0, 0, 0, 1, 1
"c:\Users\Lenovo\saitynams_fe\react_register_form-main\src\components\Recommendations\RecommendationPage.js", "JavaScript", 37, 0, 0, 0, 0, 1, 5, 43
"c:\Users\Lenovo\saitynams_fe\react_register_form-main\src\components\Recommendations\Recommendations.js", "JavaScript", 84, 0, 0, 0, 0, 4, 10, 98
"c:\Users\Lenovo\saitynams_fe\react_register_form-main\src\components\Recommendations\RecommendationsPage.js", "JavaScript", 15, 0, 0, 0, 0, 0, 3, 18
"c:\Users\Lenovo\saitynams_fe\react_register_form-main\src\components\Therapies\CreateTherapy.js", "JavaScript", 0, 0, 0, 0, 0, 0, 1, 1
"c:\Users\Lenovo\saitynams_fe\react_register_form-main\src\components\Therapies\EditTherapy.js", "JavaScript", 0, 0, 0, 0, 0, 0, 1, 1
"c:\Users\Lenovo\saitynams_fe\react_register_form-main\src\components\Therapies\Therapies.js", "JavaScript", 92, 0, 0, 0, 0, 4, 10, 106
"c:\Users\Lenovo\saitynams_fe\react_register_form-main\src\components\Therapies\TherapiesPage.js", "JavaScript", 13, 0, 0, 0, 0, 0, 2, 15
"c:\Users\Lenovo\saitynams_fe\react_register_form-main\src\components\Therapies\TherapyPage.js", "JavaScript", 39, 0, 0, 0, 0, 1, 5, 45
"c:\Users\Lenovo\saitynams_fe\react_register_form-main\src\components\Users\Admin.js", "JavaScript", 13, 0, 0, 0, 0, 0, 2, 15
"c:\Users\Lenovo\saitynams_fe\react_register_form-main\src\components\Users\Users.js", "JavaScript", 59, 0, 0, 0, 0, 0, 8, 67
"c:\Users\Lenovo\saitynams_fe\react_register_form-main\src\context\AuthProvider.js", "JavaScript", 11, 0, 0, 0, 0, 0, 4, 15
"c:\Users\Lenovo\saitynams_fe\react_register_form-main\src\hooks\UseAuth.js", "JavaScript", 6, 0, 0, 0, 0, 0, 2, 8
"c:\Users\Lenovo\saitynams_fe\react_register_form-main\src\hooks\UseAxiosPrivate.js", "JavaScript", 37, 0, 0, 0, 0, 0, 7, 44
"c:\Users\Lenovo\saitynams_fe\react_register_form-main\src\hooks\userRefreshToken.js", "JavaScript", 22, 0, 0, 0, 0, 0, 3, 25
"c:\Users\Lenovo\saitynams_fe\react_register_form-main\src\index.css", "CSS", 0, 200, 0, 0, 0, 0, 38, 238
"c:\Users\Lenovo\saitynams_fe\react_register_form-main\src\index.js", "JavaScript", 18, 0, 0, 0, 0, 0, 1, 19
"Total", "-", 1267, 200, 27270, 9, 17, 49, 241, 29053